junction:A_A rigid:0_9	CTAGGATATGGAAGATCCTGGGGAACTGGGATCTACCTAAGTCCTAG	-23.80	(((((((..((.(((((((((....))))))))).))...)))))))
junction:A_A rigid:1_8	CTAGGATATGGAAGATCCTGGGGAACTGGGATCATCCTAAGTCCTAG	-24.10	(((((((..(((.((((((((....)))))))).)))...)))))))
junction:A_A rigid:2_7	CTAGGATATGGAAAATCCTGGGGAACTGGGATATTCCTAAGTCCTAG	-21.90	(((((((..((((.(((((((....))))))).))))...)))))))
junction:A_A rigid:3_6	CTAGGATATGGAAGATCCTGGGGAACTGGGAACTTCCTAAGTCCTAG	-23.60	(((((((..(((((.((((((....)))))).)))))...)))))))
junction:A_A rigid:4_5	CTAGGATATGGAAGAACCTGGGGAACTGGGATCTTCCTAAGTCCTAG	-23.60	(((((((..((((((.(((((....))))).))))))...)))))))
junction:A_A rigid:5_4	CTAGGATATGGAAGATACTGGGGAACTGGAATCTTCCTAAGTCCTAG	-21.40	(((((((..(((((((.((((....)))).)))))))...)))))))
junction:A_A rigid:6_3	CTAGGATATGGAAGATCATGGGGAACTGAGATCTTCCTAAGTCCTAG	-22.30	(((((((..((((((((.(((....))).))))))))...)))))))
junction:A_A rigid:7_2	CTAGGATATGGAAGATCCAGGGGAACTAGGATCTTCCTAAGTCCTAG	-24.70	(((((((..(((((((((((.....)).)))))))))...)))))))
junction:A_A rigid:8_1	CTAGGATATGGAAGATCCTAGGGAACAGGGATCTTCCTAAGTCCTAG	-24.60	(((((((..((((((((((........))))))))))...)))))))
junction:A_A rigid:9_0	CTAGGATATGGAAGATCCTGAGGAAATGGGATCTTCCTAAGTCCTAG	-24.40	(((((((..((((((((((........))))))))))...)))))))
junction:A_G rigid:0_9	CTAGGATATGGAAGATCCTGGGGAACTGGGATCTGCCTAAGTCCTAG	-24.00	(((((((.(((.(((((((((....)))))))))..))).)))))))
junction:A_G rigid:1_8	CTAGGATATGGAAGATCCTGGGGAACTGGGATCGTCCTAAGTCCTAG	-24.10	(((((((..(((.((((((((....)))))))).)))...)))))))
junction:A_G rigid:2_7	CTAGGATATGGAAAATCCTGGGGAACTGGGATGTTCCTAAGTCCTAG	-21.90	(((((((..((((.(((((((....))))))).))))...)))))))
junction:A_G rigid:3_6	CTAGGATATGGAAGATCCTGGGGAACTGGGAGCTTCCTAAGTCCTAG	-23.60	(((((((..(((((.((((((....)))))).)))))...)))))))
junction:A_G rigid:4_5	CTAGGATATGGAAGAACCTGGGGAACTGGGGTCTTCCTAAGTCCTAG	-23.60	(((((((..((((((.(((((....))))).))))))...)))))))
junction:A_G rigid:5_4	CTAGGATATGGAAGATACTGGGGAACTGGGATCTTCCTAAGTCCTAG	-21.60	(((((((..((((((..((((....))))..))))))...)))))))
junction:A_G rigid:6_3	CTAGGATATGGAAGATCATGGGGAACTGGGATCTTCCTAAGTCCTAG	-22.20	(((((((..((((((((..((....))..))))))))...)))))))
junction:A_G rigid:7_2	CTAGGATATGGAAGATCCAGGGGAACTGGGATCTTCCTAAGTCCTAG	-25.30	(((((((..(((((((((.((....)).)))))))))...)))))))
junction:A_G rigid:8_1	CTAGGATATGGAAGATCCTAGGGAACGGGGATCTTCCTAAGTCCTAG	-25.30	(((((((..((((((((((.(....).))))))))))...)))))))
junction:A_G rigid:9_0	CTAGGATATGGAAGATCCTGAGGAAGTGGGATCTTCCTAAGTCCTAG	-24.40	(((((((..((((((((((........))))))))))...)))))))
junction:A_C rigid:0_9	CTAGGATATGGAAGATCCTGGGGAACTGGGATCTCCCTAAGTCCTAG	-23.80	(((((((..((.(((((((((....))))))))).))...)))))))
junction:A_C rigid:1_8	CTAGGATATGGAAGATCCTGGGGAACTGGGATCCTCCTAAGTCCTAG	-24.10	(((((((..(((.((((((((....)))))))).)))...)))))))
junction:A_C rigid:2_7	CTAGGATATGGAAAATCCTGGGGAACTGGGATCTTCCTAAGTCCTAG	-21.90	(((((((..((((.(((((((....))))))).))))...)))))))
junction:A_C rigid:3_6	CTAGGATATGGAAGATCCTGGGGAACTGGGACCTTCCTAAGTCCTAG	-23.60	(((((((..(((((.((((((....)))))).)))))...)))))))
junction:A_C rigid:4_5	CTAGGATATGGAAGAACCTGGGGAACTGGGCTCTTCCTAAGTCCTAG	-23.60	(((((((..((((((.(((((....))))).))))))...)))))))
junction:A_C rigid:5_4	CTAGGATATGGAAGATACTGGGGAACTGGCATCTTCCTAAGTCCTAG	-21.40	(((((((..(((((((.((((....)))).)))))))...)))))))
junction:A_C rigid:6_3	CTAGGATATGGAAGATCATGGGGAACTGCGATCTTCCTAAGTCCTAG	-22.40	(((((((..((((((((.(((....))).))))))))...)))))))
junction:A_C rigid:7_2	CTAGGATATGGAAGATCCAGGGGAACTCGGATCTTCCTAAGTCCTAG	-25.20	(((((((..(((((((((.((....)).)))))))))...)))))))
junction:A_C rigid:8_1	CTAGGATATGGAAGATCCTAGGGAACCGGGATCTTCCTAAGTCCTAG	-25.30	(((((((..((((((((((.(....).))))))))))...)))))))
junction:A_C rigid:9_0	CTAGGATATGGAAGATCCTGAGGAACTGGGATCTTCCTAAGTCCTAG	-24.40	(((((((..((((((((((........))))))))))...)))))))
junction:T_T rigid:0_9	CTAGGATATGGTAGATCCTGGGGAACTGGGATCTTCCTAAGTCCTAG	-23.80	(((((((..((.(((((((((....))))))))).))...)))))))
junction:T_T rigid:1_8	CTAGGATATGGATGATCCTGGGGAACTGGGATCTTCCTAAGTCCTAG	-24.50	(((((((..(((.((((((((....)))))))).)))...)))))))
junction:T_T rigid:2_7	CTAGGATATGGAATATCCTGGGGAACTGGGATTTTCCTAAGTCCTAG	-22.30	(((((((..((((.(((((((....))))))).))))...)))))))
junction:T_T rigid:3_6	CTAGGATATGGAAGTTCCTGGGGAACTGGGATCTTCCTAAGTCCTAG	-24.00	(((((((..(((((.((((((....)))))).)))))...)))))))
junction:T_T rigid:4_5	CTAGGATATGGAAGATCCTGGGGAACTGGGTTCTTCCTAAGTCCTAG	-24.00	(((((((..((((((.(((((....))))).))))))...)))))))
junction:T_T rigid:5_4	CTAGGATATGGAAGATTCTGGGGAACTGGTATCTTCCTAAGTCCTAG	-21.40	(((((((..(((((((.((((....)))).)))))))...)))))))
junction:T_T rigid:6_3	CTAGGATATGGAAGATCTTGGGGAACTGTGATCTTCCTAAGTCCTAG	-22.00	(((((((..((((((((..((....))..))))))))...)))))))
junction:T_T rigid:7_2	CTAGGATATGGAAGATCCTGGGGAACTTGGATCTTCCTAAGTCCTAG	-25.40	(((((((..(((((((((.((....)).)))))))))...)))))))
junction:T_T rigid:8_1	CTAGGATATGGAAGATCCTTGGGAACTGGGATCTTCCTAAGTCCTAG	-25.40	(((((((..((((((((((.(....).))))))))))...)))))))
junction:T_T rigid:9_0	CTAGGATATGGAAGATCCTGTGGAATTGGGATCTTCCTAAGTCCTAG	-24.90	(((((((..(((((((((((......)))))))))))...)))))))
junction:T_G rigid:0_9	CTAGGATATGGTAGATCCTGGGGAACTGGGATCTGCCTAAGTCCTAG	-28.50	(((((((..((((((((((((....))))))))))))...)))))))
junction:T_G rigid:1_8	CTAGGATATGGATGATCCTGGGGAACTGGGATCGTCCTAAGTCCTAG	-28.10	(((((((..((((((((((((....))))))))))))...)))))))
junction:T_G rigid:2_7	CTAGGATATGGAATATCCTGGGGAACTGGGATGTTCCTAAGTCCTAG	-26.20	(((((((..((((((((((((....))))))))))))...)))))))
junction:T_G rigid:3_6	CTAGGATATGGAAGTTCCTGGGGAACTGGGAGCTTCCTAAGTCCTAG	-27.90	(((((((..((((((((((((....))))))))))))...)))))))
junction:T_G rigid:4_5	CTAGGATATGGAAGATCCTGGGGAACTGGGGTCTTCCTAAGTCCTAG	-27.70	(((((((..((((((((((((....))))))))))))...)))))))
junction:T_G rigid:5_4	CTAGGATATGGAAGATTCTGGGGAACTGGGATCTTCCTAAGTCCTAG	-25.40	(((((((..((((((((((((....))))))))))))...)))))))
junction:T_G rigid:6_3	CTAGGATATGGAAGATCTTGGGGAACTGGGATCTTCCTAAGTCCTAG	-25.50	(((((((..((((((((((((....))))))))))))...)))))))
junction:T_G rigid:7_2	CTAGGATATGGAAGATCCTGGGGAACTGGGATCTTCCTAAGTCCTAG	-28.30	(((((((..((((((((((((....))))))))))))...)))))))
junction:T_G rigid:8_1	CTAGGATATGGAAGATCCTTGGGAACGGGGATCTTCCTAAGTCCTAG	-28.40	(((((((..((((((((((((....))))))))))))...)))))))
junction:T_G rigid:9_0	CTAGGATATGGAAGATCCTGTGGAAGTGGGATCTTCCTAAGTCCTAG	-24.40	(((((((..((((((((((........))))))))))...)))))))
junction:T_C rigid:0_9	CTAGGATATGGTAGATCCTGGGGAACTGGGATCTCCCTAAGTCCTAG	-23.80	(((((((..((.(((((((((....))))))))).))...)))))))
junction:T_C rigid:1_8	CTAGGATATGGATGATCCTGGGGAACTGGGATCCTCCTAAGTCCTAG	-24.10	(((((((..(((.((((((((....)))))))).)))...)))))))
junction:T_C rigid:2_7	CTAGGATATGGAATATCCTGGGGAACTGGGATCTTCCTAAGTCCTAG	-21.90	(((((((..((((.(((((((....))))))).))))...)))))))
junction:T_C rigid:3_6	CTAGGATATGGAAGTTCCTGGGGAACTGGGACCTTCCTAAGTCCTAG	-23.60	(((((((..(((((.((((((....)))))).)))))...)))))))
junction:T_C rigid:4_5	CTAGGATATGGAAGATCCTGGGGAACTGGGCTCTTCCTAAGTCCTAG	-23.60	(((((((..((((((.(((((....))))).))))))...)))))))
junction:T_C rigid:5_4	CTAGGATATGGAAGATTCTGGGGAACTGGCATCTTCCTAAGTCCTAG	-21.40	(((((((..(((((((.((((....)))).)))))))...)))))))
junction:T_C rigid:6_3	CTAGGATATGGAAGATCTTGGGGAACTGCGATCTTCCTAAGTCCTAG	-21.90	(((((((..((((((((.(((....))).))))))))...)))))))
junction:T_C rigid:7_2	CTAGGATATGGAAGATCCTGGGGAACTCGGATCTTCCTAAGTCCTAG	-25.30	(((((((..(((((((((.((....)).)))))))))...)))))))
junction:T_C rigid:8_1	CTAGGATATGGAAGATCCTTGGGAACCGGGATCTTCCTAAGTCCTAG	-25.30	(((((((..((((((((((.(....).))))))))))...)))))))
junction:T_C rigid:9_0	CTAGGATATGGAAGATCCTGTGGAACTGGGATCTTCCTAAGTCCTAG	-24.40	(((((((..((((((((((........))))))))))...)))))))
junction:G_A rigid:0_9	CTAGGATATGGGAGATCCTGGGGAACTGGGATCTACCTAAGTCCTAG	-27.80	(((((((.(((((((((((((....))))))))).)))).)))))))
junction:G_A rigid:1_8	CTAGGATATGGAGGATCCTGGGGAACTGGGATCATCCTAAGTCCTAG	-24.10	(((((((..(((.((((((((....)))))))).)))...)))))))
junction:G_A rigid:2_7	CTAGGATATGGAAGATCCTGGGGAACTGGGATATTCCTAAGTCCTAG	-21.90	(((((((..((((.(((((((....))))))).))))...)))))))
junction:G_A rigid:3_6	CTAGGATATGGAAGGTCCTGGGGAACTGGGAACTTCCTAAGTCCTAG	-23.60	(((((((..(((((.((((((....)))))).)))))...)))))))
junction:G_A rigid:4_5	CTAGGATATGGAAGAGCCTGGGGAACTGGGATCTTCCTAAGTCCTAG	-23.60	(((((((..((((((.(((((....))))).))))))...)))))))
junction:G_A rigid:5_4	CTAGGATATGGAAGATGCTGGGGAACTGGAATCTTCCTAAGTCCTAG	-21.40	(((((((..(((((((.((((....)))).)))))))...)))))))
junction:G_A rigid:6_3	CTAGGATATGGAAGATCGTGGGGAACTGAGATCTTCCTAAGTCCTAG	-23.10	(((((((..((((((((.(((....))).))))))))...)))))))
junction:G_A rigid:7_2	CTAGGATATGGAAGATCCGGGGGAACTAGGATCTTCCTAAGTCCTAG	-25.30	(((((((..(((((((((.((....)).)))))))))...)))))))
junction:G_A rigid:8_1	CTAGGATATGGAAGATCCTGGGGAACAGGGATCTTCCTAAGTCCTAG	-25.30	(((((((..((((((((((.(....).))))))))))...)))))))
junction:G_A rigid:9_0	CTAGGATATGGAAGATCCTGGGGAAATGGGATCTTCCTAAGTCCTAG	-24.90	(((((((..(((((((((((......)))))))))))...)))))))
junction:G_T rigid:0_9	CTAGGATATGGGAGATCCTGGGGAACTGGGATCTTCCTAAGTCCTAG	-27.80	(((((((.(((((((((((((....)))))))).))))).)))))))
junction:G_T rigid:1_8	CTAGGATATGGAGGATCCTGGGGAACTGGGATCTTCCTAAGTCCTAG	-28.00	(((((((..((((((((((((....))))))))))))...)))))))
junction:G_T rigid:2_7	CTAGGATATGGAAGATCCTGGGGAACTGGGATTTTCCTAAGTCCTAG	-25.70	(((((((..((((((((((((....))))))))))))...)))))))
junction:G_T rigid:3_6	CTAGGATATGGAAGGTCCTGGGGAACTGGGATCTTCCTAAGTCCTAG	-27.70	(((((((..((((((((((((....))))))))))))...)))))))
junction:G_T rigid:4_5	CTAGGATATGGAAGAGCCTGGGGAACTGGGTTCTTCCTAAGTCCTAG	-27.90	(((((((..((((((((((((....))))))))))))...)))))))
junction:G_T rigid:5_4	CTAGGATATGGAAGATGCTGGGGAACTGGTATCTTCCTAAGTCCTAG	-26.10	(((((((..((((((((((((....))))))))))))...)))))))
junction:G_T rigid:6_3	CTAGGATATGGAAGATCGTGGGGAACTGTGATCTTCCTAAGTCCTAG	-23.00	(((((((..((((((((((((....))))))))))))...)))))))
junction:G_T rigid:7_2	CTAGGATATGGAAGATCCGGGGGAACTTGGATCTTCCTAAGTCCTAG	-28.40	(((((((..((((((((((((....))))))))))))...)))))))
junction:G_T rigid:8_1	CTAGGATATGGAAGATCCTGGGGAACTGGGATCTTCCTAAGTCCTAG	-28.30	(((((((..((((((((((((....))))))))))))...)))))))
junction:G_T rigid:9_0	CTAGGATATGGAAGATCCTGGGGAATTGGGATCTTCCTAAGTCCTAG	-25.20	(((((((..((((((((((((....))))))))))))...)))))))
junction:G_G rigid:0_9	CTAGGATATGGGAGATCCTGGGGAACTGGGATCTGCCTAAGTCCTAG	-27.80	(((((((.(((((((((((((....))))))))).)))).)))))))
junction:G_G rigid:1_8	CTAGGATATGGAGGATCCTGGGGAACTGGGATCGTCCTAAGTCCTAG	-26.70	(((((((..(((.((((((((....)))))))).)))...)))))))
junction:G_G rigid:2_7	CTAGGATATGGAAGATCCTGGGGAACTGGGATGTTCCTAAGTCCTAG	-24.50	(((((((..((((.(((((((....))))))).))))...)))))))
junction:G_G rigid:3_6	CTAGGATATGGAAGGTCCTGGGGAACTGGGAGCTTCCTAAGTCCTAG	-26.20	(((((((..(((((.((((((....)))))).)))))...)))))))
junction:G_G rigid:4_5	CTAGGATATGGAAGAGCCTGGGGAACTGGGGTCTTCCTAAGTCCTAG	-26.20	(((((((..((((((.(((((....))))).))))))...)))))))
junction:G_G rigid:5_4	CTAGGATATGGAAGATGCTGGGGAACTGGGATCTTCCTAAGTCCTAG	-24.00	(((((((..(((((((.((((....)))).)))))))...)))))))
junction:G_G rigid:6_3	CTAGGATATGGAAGATCGTGGGGAACTGGGATCTTCCTAAGTCCTAG	-24.30	(((((((..((((((((.(((....))).))))))))...)))))))
junction:G_G rigid:7_2	CTAGGATATGGAAGATCCGGGGGAACTGGGATCTTCCTAAGTCCTAG	-27.90	(((((((..(((((((((.((....)).)))))))))...)))))))
junction:G_G rigid:8_1	CTAGGATATGGAAGATCCTGGGGAACGGGGATCTTCCTAAGTCCTAG	-27.90	(((((((..((((((((((.(....).))))))))))...)))))))
junction:G_G rigid:9_0	CTAGGATATGGAAGATCCTGGGGAAGTGGGATCTTCCTAAGTCCTAG	-25.00	(((((((..(((((((((((......)))))))))))...)))))))
junction:C_A rigid:0_9	CTAGGATATGGCAGATCCTGGGGAACTGGGATCTACCTAAGTCCTAG	-23.80	(((((((..((.(((((((((....))))))))).))...)))))))
junction:C_A rigid:1_8	CTAGGATATGGACGATCCTGGGGAACTGGGATCATCCTAAGTCCTAG	-24.10	(((((((..(((.((((((((....)))))))).)))...)))))))
junction:C_A rigid:2_7	CTAGGATATGGAACATCCTGGGGAACTGGGATATTCCTAAGTCCTAG	-21.90	(((((((..((((.(((((((....))))))).))))...)))))))
junction:C_A rigid:3_6	CTAGGATATGGAAGCTCCTGGGGAACTGGGAACTTCCTAAGTCCTAG	-23.60	(((((((..(((((.((((((....)))))).)))))...)))))))
junction:C_A rigid:4_5	CTAGGATATGGAAGACCCTGGGGAACTGGGATCTTCCTAAGTCCTAG	-23.60	(((((((..((((((.(((((....))))).))))))...)))))))
junction:C_A rigid:5_4	CTAGGATATGGAAGATCCTGGGGAACTGGAATCTTCCTAAGTCCTAG	-21.40	(((((((..(((((((.((((....)))).)))))))...)))))))
junction:C_A rigid:6_3	CTAGGATATGGAAGATCCTGGGGAACTGAGATCTTCCTAAGTCCTAG	-21.70	(((((((..((((((((.(((....))).))))))))...)))))))
junction:C_A rigid:7_2	CTAGGATATGGAAGATCCCGGGGAACTAGGATCTTCCTAAGTCCTAG	-25.30	(((((((..(((((((((.((....)).)))))))))...)))))))
junction:C_A rigid:8_1	CTAGGATATGGAAGATCCTCGGGAACAGGGATCTTCCTAAGTCCTAG	-25.20	(((((((..((((((((((.(....).))))))))))...)))))))
junction:C_A rigid:9_0	CTAGGATATGGAAGATCCTGCGGAAATGGGATCTTCCTAAGTCCTAG	-24.40	(((((((..((((((((((........))))))))))...)))))))
junction:C_T rigid:0_9	CTAGGATATGGCAGATCCTGGGGAACTGGGATCTTCCTAAGTCCTAG	-23.80	(((((((..((.(((((((((....))))))))).))...)))))))
junction:C_T rigid:1_8	CTAGGATATGGACGATCCTGGGGAACTGGGATCTTCCTAAGTCCTAG	-24.10	(((((((..(((.((((((((....)))))))).)))...)))))))
junction:C_T rigid:2_7	CTAGGATATGGAACATCCTGGGGAACTGGGATTTTCCTAAGTCCTAG	-21.90	(((((((..((((.(((((((....))))))).))))...)))))))
junction:C_T rigid:3_6	CTAGGATATGGAAGCTCCTGGGGAACTGGGATCTTCCTAAGTCCTAG	-23.60	(((((((..(((((.((((((....)))))).)))))...)))))))
junction:C_T rigid:4_5	CTAGGATATGGAAGACCCTGGGGAACTGGGTTCTTCCTAAGTCCTAG	-23.60	(((((((..((((((.(((((....))))).))))))...)))))))
junction:C_T rigid:5_4	CTAGGATATGGAAGATCCTGGGGAACTGGTATCTTCCTAAGTCCTAG	-21.40	(((((((..(((((((.((((....)))).)))))))...)))))))
junction:C_T rigid:6_3	CTAGGATATGGAAGATCCTGGGGAACTGTGATCTTCCTAAGTCCTAG	-21.70	(((((((..((((((((.(((....))).))))))))...)))))))
junction:C_T rigid:7_2	CTAGGATATGGAAGATCCCGGGGAACTTGGATCTTCCTAAGTCCTAG	-25.30	(((((((..(((((((((.((....)).)))))))))...)))))))
junction:C_T rigid:8_1	CTAGGATATGGAAGATCCTCGGGAACTGGGATCTTCCTAAGTCCTAG	-25.30	(((((((..((((((((((.(....).))))))))))...)))))))
junction:C_T rigid:9_0	CTAGGATATGGAAGATCCTGCGGAATTGGGATCTTCCTAAGTCCTAG	-24.40	(((((((..((((((((((........))))))))))...)))))))
junction:C_C rigid:0_9	CTAGGATATGGCAGATCCTGGGGAACTGGGATCTCCCTAAGTCCTAG	-23.80	(((((((..((.(((((((((....))))))))).))...)))))))
junction:C_C rigid:1_8	CTAGGATATGGACGATCCTGGGGAACTGGGATCCTCCTAAGTCCTAG	-24.10	(((((((..(((.((((((((....)))))))).)))...)))))))
junction:C_C rigid:2_7	CTAGGATATGGAACATCCTGGGGAACTGGGATCTTCCTAAGTCCTAG	-21.90	(((((((..((((.(((((((....))))))).))))...)))))))
junction:C_C rigid:3_6	CTAGGATATGGAAGCTCCTGGGGAACTGGGACCTTCCTAAGTCCTAG	-23.60	(((((((..(((((.((((((....)))))).)))))...)))))))
junction:C_C rigid:4_5	CTAGGATATGGAAGACCCTGGGGAACTGGGCTCTTCCTAAGTCCTAG	-23.60	(((((((..((((((.(((((....))))).))))))...)))))))
junction:C_C rigid:5_4	CTAGGATATGGAAGATCCTGGGGAACTGGCATCTTCCTAAGTCCTAG	-21.40	(((((((..(((((((.((((....)))).)))))))...)))))))
junction:C_C rigid:6_3	CTAGGATATGGAAGATCCTGGGGAACTGCGATCTTCCTAAGTCCTAG	-21.70	(((((((..((((((((.(((....))).))))))))...)))))))
junction:C_C rigid:7_2	CTAGGATATGGAAGATCCCGGGGAACTCGGATCTTCCTAAGTCCTAG	-24.80	(((((((..(((((((((.((....)).)))))))))...)))))))
junction:C_C rigid:8_1	CTAGGATATGGAAGATCCTCGGGAACCGGGATCTTCCTAAGTCCTAG	-27.30	(((((((..(((((((((.(((...))))))))))))...)))))))
junction:C_C rigid:9_0	CTAGGATATGGAAGATCCTGCGGAACTGGGATCTTCCTAAGTCCTAG	-24.40	(((((((..((((((((((........))))))))))...)))))))
junction:A_ rigid:0_10	CTAGGATATGGAAAGATCCTGGGGAACTGGGATCTTCCTAAGTCCTAG	-25.60	(((((((.(((.((((((((((....)))))))))).))).)))))))
junction:A_ rigid:1_9	CTAGGATATGGAAAGATCCTGGGGAACTGGGATCTTCCTAAGTCCTAG	-25.60	(((((((.(((.((((((((((....)))))))))).))).)))))))
junction:A_ rigid:2_8	CTAGGATATGGAAAGATCCTGGGGAACTGGGATCTTCCTAAGTCCTAG	-25.60	(((((((.(((.((((((((((....)))))))))).))).)))))))
junction:A_ rigid:3_7	CTAGGATATGGAAGAATCCTGGGGAACTGGGATCTTCCTAAGTCCTAG	-24.50	(((((((..((((((.((((((....))))))))))))...)))))))
junction:A_ rigid:4_6	CTAGGATATGGAAGAATCCTGGGGAACTGGGATCTTCCTAAGTCCTAG	-24.50	(((((((..((((((.((((((....))))))))))))...)))))))
junction:A_ rigid:5_5	CTAGGATATGGAAGATACCTGGGGAACTGGGATCTTCCTAAGTCCTAG	-24.50	(((((((..(((((((.(((((....))))))))))))...)))))))
junction:A_ rigid:6_4	CTAGGATATGGAAGATCACTGGGGAACTGGGATCTTCCTAAGTCCTAG	-24.50	(((((((..((((((((.((((....))))))))))))...)))))))
junction:A_ rigid:7_3	CTAGGATATGGAAGATCCATGGGGAACTGGGATCTTCCTAAGTCCTAG	-24.80	(((((((..(((((((((..(.....)..)))))))))...)))))))
junction:A_ rigid:8_2	CTAGGATATGGAAGATCCTAGGGGAACTGGGATCTTCCTAAGTCCTAG	-29.50	(((((((..((((((((((((.....))))))))))))...)))))))
junction:A_ rigid:9_1	CTAGGATATGGAAGATCCTGAGGGAACTGGGATCTTCCTAAGTCCTAG	-25.80	(((((((..((((((((((.((....))))))))))))...)))))))
junction:A_ rigid:10_0	CTAGGATATGGAAGATCCTGGAGGAACTGGGATCTTCCTAAGTCCTAG	-26.80	(((((((..((((((((((((.....))))))))))))...)))))))
junction:T_ rigid:0_10	CTAGGATATGGTAAGATCCTGGGGAACTGGGATCTTCCTAAGTCCTAG	-25.60	(((((((.(((.((((((((((....)))))))))).))).)))))))
junction:T_ rigid:1_9	CTAGGATATGGATAGATCCTGGGGAACTGGGATCTTCCTAAGTCCTAG	-24.90	(((((((.(((..(((((((((....)))))))))..))).)))))))
junction:T_ rigid:2_8	CTAGGATATGGAATGATCCTGGGGAACTGGGATCTTCCTAAGTCCTAG	-24.50	(((((((..((((.((((((((....))))))))))))...)))))))
junction:T_ rigid:3_7	CTAGGATATGGAAGTATCCTGGGGAACTGGGATCTTCCTAAGTCCTAG	-24.50	(((((((..(((((.(((((((....))))))))))))...)))))))
junction:T_ rigid:4_6	CTAGGATATGGAAGATTCCTGGGGAACTGGGATCTTCCTAAGTCCTAG	-24.50	(((((((..((((((((((.((....))))))))))))...)))))))
junction:T_ rigid:5_5	CTAGGATATGGAAGATTCCTGGGGAACTGGGATCTTCCTAAGTCCTAG	-24.50	(((((((..((((((((((.((....))))))))))))...)))))))
junction:T_ rigid:6_4	CTAGGATATGGAAGATCTCTGGGGAACTGGGATCTTCCTAAGTCCTAG	-24.50	(((((((..((((((((.((((....))))))))))))...)))))))
junction:T_ rigid:7_3	CTAGGATATGGAAGATCCTTGGGGAACTGGGATCTTCCTAAGTCCTAG	-25.30	(((((((..((((((((((.(.....).))))))))))...)))))))
junction:T_ rigid:8_2	CTAGGATATGGAAGATCCTTGGGGAACTGGGATCTTCCTAAGTCCTAG	-25.30	(((((((..((((((((((.(.....).))))))))))...)))))))
junction:T_ rigid:9_1	CTAGGATATGGAAGATCCTGTGGGAACTGGGATCTTCCTAAGTCCTAG	-25.30	(((((((..((((((((((((....)).))))))))))...)))))))
junction:T_ rigid:10_0	CTAGGATATGGAAGATCCTGGTGGAACTGGGATCTTCCTAAGTCCTAG	-27.70	(((((((..(((((((((((((...)))))))))))))...)))))))
junction:G_ rigid:0_10	CTAGGATATGGGAAGATCCTGGGGAACTGGGATCTTCCTAAGTCCTAG	-32.50	(((((((.((((((((((((((....)))))))))))))).)))))))
junction:G_ rigid:1_9	CTAGGATATGGAGAGATCCTGGGGAACTGGGATCTTCCTAAGTCCTAG	-26.00	(((((((.(((.((((((((((....)))))))))).))).)))))))
junction:G_ rigid:2_8	CTAGGATATGGAAGGATCCTGGGGAACTGGGATCTTCCTAAGTCCTAG	-25.30	(((((((.(((.((((((((((....)))))))))).))).)))))))
junction:G_ rigid:3_7	CTAGGATATGGAAGGATCCTGGGGAACTGGGATCTTCCTAAGTCCTAG	-25.30	(((((((.(((.((((((((((....)))))))))).))).)))))))
junction:G_ rigid:4_6	CTAGGATATGGAAGAGTCCTGGGGAACTGGGATCTTCCTAAGTCCTAG	-24.50	(((((((..((((((.((((((....))))))))))))...)))))))
junction:G_ rigid:5_5	CTAGGATATGGAAGATGCCTGGGGAACTGGGATCTTCCTAAGTCCTAG	-24.50	(((((((..(((((((.(((((....))))))))))))...)))))))
junction:G_ rigid:6_4	CTAGGATATGGAAGATCGCTGGGGAACTGGGATCTTCCTAAGTCCTAG	-24.50	(((((((..((((((((.((((....))))))))))))...)))))))
junction:G_ rigid:7_3	CTAGGATATGGAAGATCCGTGGGGAACTGGGATCTTCCTAAGTCCTAG	-24.60	(((((((..(((((((((..((....)).)))))))))...)))))))
junction:G_ rigid:8_2	CTAGGATATGGAAGATCCTGGGGGAACTGGGATCTTCCTAAGTCCTAG	-28.20	(((((((..((((((((((((.....))))))))))))...)))))))
junction:G_ rigid:9_1	CTAGGATATGGAAGATCCTGGGGGAACTGGGATCTTCCTAAGTCCTAG	-28.20	(((((((..((((((((((((.....))))))))))))...)))))))
junction:G_ rigid:10_0	CTAGGATATGGAAGATCCTGGGGGAACTGGGATCTTCCTAAGTCCTAG	-28.20	(((((((..((((((((((((.....))))))))))))...)))))))
junction:C_ rigid:0_10	CTAGGATATGGCAAGATCCTGGGGAACTGGGATCTTCCTAAGTCCTAG	-25.60	(((((((.(((.((((((((((....)))))))))).))).)))))))
junction:C_ rigid:1_9	CTAGGATATGGACAGATCCTGGGGAACTGGGATCTTCCTAAGTCCTAG	-24.50	(((((((..(((.(((((((((....))))))))))))...)))))))
junction:C_ rigid:2_8	CTAGGATATGGAACGATCCTGGGGAACTGGGATCTTCCTAAGTCCTAG	-24.50	(((((((..((((.((((((((....))))))))))))...)))))))
junction:C_ rigid:3_7	CTAGGATATGGAAGCATCCTGGGGAACTGGGATCTTCCTAAGTCCTAG	-24.50	(((((((..(((((.(((((((....))))))))))))...)))))))
junction:C_ rigid:4_6	CTAGGATATGGAAGACTCCTGGGGAACTGGGATCTTCCTAAGTCCTAG	-24.50	(((((((..((((((.((((((....))))))))))))...)))))))
junction:C_ rigid:5_5	CTAGGATATGGAAGATCCCTGGGGAACTGGGATCTTCCTAAGTCCTAG	-27.40	(((((((..((((((((((.((....))))))))))))...)))))))
junction:C_ rigid:6_4	CTAGGATATGGAAGATCCCTGGGGAACTGGGATCTTCCTAAGTCCTAG	-27.40	(((((((..((((((((((.((....))))))))))))...)))))))
junction:C_ rigid:7_3	CTAGGATATGGAAGATCCCTGGGGAACTGGGATCTTCCTAAGTCCTAG	-27.40	(((((((..((((((((((.((....))))))))))))...)))))))
junction:C_ rigid:8_2	CTAGGATATGGAAGATCCTCGGGGAACTGGGATCTTCCTAAGTCCTAG	-27.40	(((((((..(((((((((.(((....))))))))))))...)))))))
junction:C_ rigid:9_1	CTAGGATATGGAAGATCCTGCGGGAACTGGGATCTTCCTAAGTCCTAG	-24.50	(((((((..(((((((((((.(....))))))))))))...)))))))
junction:C_ rigid:10_0	CTAGGATATGGAAGATCCTGGCGGAACTGGGATCTTCCTAAGTCCTAG	-26.80	(((((((..((((((((((((.....))))))))))))...)))))))
junction:_A rigid:0_10	CTAGGATATGGAAGATCCTGGGGAACTGGGATCTTACCTAAGTCCTAG	-24.50	(((((((..((((((((((((....)))))))))).))...)))))))
junction:_A rigid:1_9	CTAGGATATGGAAGATCCTGGGGAACTGGGATCTATCCTAAGTCCTAG	-24.50	(((((((..((((((((((((....))))))))).)))...)))))))
junction:_A rigid:2_8	CTAGGATATGGAAGATCCTGGGGAACTGGGATCATTCCTAAGTCCTAG	-24.50	(((((((..((((((((((((....)))))))).))))...)))))))
junction:_A rigid:3_7	CTAGGATATGGAAGATCCTGGGGAACTGGGATACTTCCTAAGTCCTAG	-24.50	(((((((..((((((((((((....))))))).)))))...)))))))
junction:_A rigid:4_6	CTAGGATATGGAAGATCCTGGGGAACTGGGAATCTTCCTAAGTCCTAG	-24.50	(((((((..((((((((((((....))))).)))))))...)))))))
junction:_A rigid:5_5	CTAGGATATGGAAGATCCTGGGGAACTGGGAATCTTCCTAAGTCCTAG	-24.50	(((((((..((((((((((((....))))).)))))))...)))))))
junction:_A rigid:6_4	CTAGGATATGGAAGATCCTGGGGAACTGGAGATCTTCCTAAGTCCTAG	-24.50	(((((((..((((((((((((....)))).))))))))...)))))))
junction:_A rigid:7_3	CTAGGATATGGAAGATCCTGGGGAACTGAGGATCTTCCTAAGTCCTAG	-27.00	(((((((..((((((((((.((...)).))))))))))...)))))))
junction:_A rigid:8_2	CTAGGATATGGAAGATCCTGGGGAACTAGGGATCTTCCTAAGTCCTAG	-25.80	(((((((..((((((((((((....))).)))))))))...)))))))
junction:_A rigid:9_1	CTAGGATATGGAAGATCCTGGGGAACATGGGATCTTCCTAAGTCCTAG	-24.60	(((((((..((((((((((.(....)..))))))))))...)))))))
junction:_A rigid:10_0	CTAGGATATGGAAGATCCTGGGGAAACTGGGATCTTCCTAAGTCCTAG	-28.20	(((((((..((((((((((((.....))))))))))))...)))))))
junction:_T rigid:0_10	CTAGGATATGGAAGATCCTGGGGAACTGGGATCTTTCCTAAGTCCTAG	-24.50	(((((((..((((((((((((....)))))))).))))...)))))))
junction:_T rigid:1_9	CTAGGATATGGAAGATCCTGGGGAACTGGGATCTTTCCTAAGTCCTAG	-24.50	(((((((..((((((((((((....)))))))).))))...)))))))
junction:_T rigid:2_8	CTAGGATATGGAAGATCCTGGGGAACTGGGATCTTTCCTAAGTCCTAG	-24.50	(((((((..((((((((((((....)))))))).))))...)))))))
junction:_T rigid:3_7	CTAGGATATGGAAGATCCTGGGGAACTGGGATTCTTCCTAAGTCCTAG	-24.50	(((((((..((((((((((((....)))))).))))))...)))))))
junction:_T rigid:4_6	CTAGGATATGGAAGATCCTGGGGAACTGGGATTCTTCCTAAGTCCTAG	-24.50	(((((((..((((((((((((....)))))).))))))...)))))))
junction:_T rigid:5_5	CTAGGATATGGAAGATCCTGGGGAACTGGGTATCTTCCTAAGTCCTAG	-24.50	(((((((..((((((((((((....))))).)))))))...)))))))
junction:_T rigid:6_4	CTAGGATATGGAAGATCCTGGGGAACTGGTGATCTTCCTAAGTCCTAG	-24.50	(((((((..((((((((((((....)))).))))))))...)))))))
junction:_T rigid:7_3	CTAGGATATGGAAGATCCTGGGGAACTGTGGATCTTCCTAAGTCCTAG	-24.50	(((((((..((((((((((((....))).)))))))))...)))))))
junction:_T rigid:8_2	CTAGGATATGGAAGATCCTGGGGAACTTGGGATCTTCCTAAGTCCTAG	-26.50	(((((((..(((((((((((((...)))))))))))))...)))))))
junction:_T rigid:9_1	CTAGGATATGGAAGATCCTGGGGAACTTGGGATCTTCCTAAGTCCTAG	-26.50	(((((((..(((((((((((((...)))))))))))))...)))))))
junction:_T rigid:10_0	CTAGGATATGGAAGATCCTGGGGAATCTGGGATCTTCCTAAGTCCTAG	-27.20	(((((((..((((((((((((.....))))))))))))...)))))))
junction:_G rigid:0_10	CTAGGATATGGAAGATCCTGGGGAACTGGGATCTTGCCTAAGTCCTAG	-24.50	(((((((..((((((((((((....)))))))))).))...)))))))
junction:_G rigid:1_9	CTAGGATATGGAAGATCCTGGGGAACTGGGATCTGTCCTAAGTCCTAG	-24.50	(((((((..((((((((((((....))))))))).)))...)))))))
junction:_G rigid:2_8	CTAGGATATGGAAGATCCTGGGGAACTGGGATCGTTCCTAAGTCCTAG	-24.50	(((((((..((((((((((((....)))))))).))))...)))))))
junction:_G rigid:3_7	CTAGGATATGGAAGATCCTGGGGAACTGGGATGCTTCCTAAGTCCTAG	-24.50	(((((((..((((((((((((....))))))).)))))...)))))))
junction:_G rigid:4_6	CTAGGATATGGAAGATCCTGGGGAACTGGGAGTCTTCCTAAGTCCTAG	-24.50	(((((((..((((((((((((....)))))).))))))...)))))))
junction:_G rigid:5_5	CTAGGATATGGAAGATCCTGGGGAACTGGGGATCTTCCTAAGTCCTAG	-27.00	(((((((..((((((((((.((...)).))))))))))...)))))))
junction:_G rigid:6_4	CTAGGATATGGAAGATCCTGGGGAACTGGGGATCTTCCTAAGTCCTAG	-27.00	(((((((..((((((((((.((...)).))))))))))...)))))))
junction:_G rigid:7_3	CTAGGATATGGAAGATCCTGGGGAACTGGGGATCTTCCTAAGTCCTAG	-27.00	(((((((..((((((((((.((...)).))))))))))...)))))))
junction:_G rigid:8_2	CTAGGATATGGAAGATCCTGGGGAACTGGGGATCTTCCTAAGTCCTAG	-27.00	(((((((..((((((((((.((...)).))))))))))...)))))))
junction:_G rigid:9_1	CTAGGATATGGAAGATCCTGGGGAACGTGGGATCTTCCTAAGTCCTAG	-25.30	(((((((..(((((((((((.(...).)))))))))))...)))))))
junction:_G rigid:10_0	CTAGGATATGGAAGATCCTGGGGAAGCTGGGATCTTCCTAAGTCCTAG	-27.90	(((((((..((((((((((((.....))))))))))))...)))))))
junction:_C rigid:0_10	CTAGGATATGGAAGATCCTGGGGAACTGGGATCTTCCCTAAGTCCTAG	-27.40	(((((((..((((((((((((....))))))))))))....)))))))
junction:_C rigid:1_9	CTAGGATATGGAAGATCCTGGGGAACTGGGATCTCTCCTAAGTCCTAG	-24.50	(((((((..((((((((((((....))))))))).)))...)))))))
junction:_C rigid:2_8	CTAGGATATGGAAGATCCTGGGGAACTGGGATCCTTCCTAAGTCCTAG	-24.50	(((((((..((((((((((((....))))))).)))))...)))))))
junction:_C rigid:3_7	CTAGGATATGGAAGATCCTGGGGAACTGGGATCCTTCCTAAGTCCTAG	-24.50	(((((((..((((((((((((....))))))).)))))...)))))))
junction:_C rigid:4_6	CTAGGATATGGAAGATCCTGGGGAACTGGGACTCTTCCTAAGTCCTAG	-24.50	(((((((..((((((((((((....)))))).))))))...)))))))
junction:_C rigid:5_5	CTAGGATATGGAAGATCCTGGGGAACTGGGCATCTTCCTAAGTCCTAG	-24.50	(((((((..((((((((((((....))))).)))))))...)))))))
junction:_C rigid:6_4	CTAGGATATGGAAGATCCTGGGGAACTGGCGATCTTCCTAAGTCCTAG	-24.50	(((((((..((((((((((((....)))).))))))))...)))))))
junction:_C rigid:7_3	CTAGGATATGGAAGATCCTGGGGAACTGCGGATCTTCCTAAGTCCTAG	-24.50	(((((((..((((((((((((....))).)))))))))...)))))))
junction:_C rigid:8_2	CTAGGATATGGAAGATCCTGGGGAACTCGGGATCTTCCTAAGTCCTAG	-29.20	(((((((..(((((((((((((...)))))))))))))...)))))))
junction:_C rigid:9_1	CTAGGATATGGAAGATCCTGGGGAACCTGGGATCTTCCTAAGTCCTAG	-29.30	(((((((..(((((((((((((...)))))))))))))...)))))))
junction:_C rigid:10_0	CTAGGATATGGAAGATCCTGGGGAACCTGGGATCTTCCTAAGTCCTAG	-29.30	(((((((..(((((((((((((...)))))))))))))...)))))))
junction:A_T rigid:0_9	CTAGGATATGGAAGATCCTGGGGAACTGGGATCTTCCTAAGTCCTAG	-28.30	(((((((..((((((((((((....))))))))))))...)))))))
junction:A_T rigid:1_8	CTAGGATATGGAAGATCCTGGGGAACTGGGATCTTCCTAAGTCCTAG	-28.30	(((((((..((((((((((((....))))))))))))...)))))))
junction:A_T rigid:2_7	CTAGGATATGGAAAATCCTGGGGAACTGGGATTTTCCTAAGTCCTAG	-25.60	(((((((..((((((((((((....))))))))))))...)))))))
junction:A_T rigid:3_6	CTAGGATATGGAAGATCCTGGGGAACTGGGATCTTCCTAAGTCCTAG	-28.30	(((((((..((((((((((((....))))))))))))...)))))))
junction:A_T rigid:4_5	CTAGGATATGGAAGAACCTGGGGAACTGGGTTCTTCCTAAGTCCTAG	-27.90	(((((((..((((((((((((....))))))))))))...)))))))
junction:A_T rigid:5_4	CTAGGATATGGAAGATACTGGGGAACTGGTATCTTCCTAAGTCCTAG	-26.10	(((((((..((((((((((((....))))))))))))...)))))))
junction:A_T rigid:6_3	CTAGGATATGGAAGATCATGGGGAACTGTGATCTTCCTAAGTCCTAG	-26.40	(((((((..((((((((((((....))))))))))))...)))))))
junction:A_T rigid:7_2	CTAGGATATGGAAGATCCAGGGGAACTTGGATCTTCCTAAGTCCTAG	-29.20	(((((((..((((((((((((....))))))))))))...)))))))
junction:A_T rigid:8_1	CTAGGATATGGAAGATCCTAGGGAACTGGGATCTTCCTAAGTCCTAG	-29.60	(((((((..((((((((((((....))))))))))))...)))))))
junction:A_T rigid:9_0	CTAGGATATGGAAGATCCTGAGGAATTGGGATCTTCCTAAGTCCTAG	-26.20	(((((((..((((((((((((....))))))))))))...)))))))
junction:T_A rigid:0_9	CTAGGATATGGTAGATCCTGGGGAACTGGGATCTACCTAAGTCCTAG	-28.50	(((((((..((((((((((((....))))))))))))...)))))))
junction:T_A rigid:1_8	CTAGGATATGGATGATCCTGGGGAACTGGGATCATCCTAAGTCCTAG	-28.50	(((((((..((((((((((((....))))))))))))...)))))))
junction:T_A rigid:2_7	CTAGGATATGGAATATCCTGGGGAACTGGGATATTCCTAAGTCCTAG	-26.20	(((((((..((((((((((((....))))))))))))...)))))))
junction:T_A rigid:3_6	CTAGGATATGGAAGTTCCTGGGGAACTGGGAACTTCCTAAGTCCTAG	-27.90	(((((((..((((((((((((....))))))))))))...)))))))
junction:T_A rigid:4_5	CTAGGATATGGAAGATCCTGGGGAACTGGGATCTTCCTAAGTCCTAG	-28.30	(((((((..((((((((((((....))))))))))))...)))))))
junction:T_A rigid:5_4	CTAGGATATGGAAGATTCTGGGGAACTGGAATCTTCCTAAGTCCTAG	-25.90	(((((((..((((((((((((....))))))))))))...)))))))
junction:T_A rigid:6_3	CTAGGATATGGAAGATCTTGGGGAACTGAGATCTTCCTAAGTCCTAG	-26.30	(((((((..((((((((((((....))))))))))))...)))))))
junction:T_A rigid:7_2	CTAGGATATGGAAGATCCTGGGGAACTAGGATCTTCCTAAGTCCTAG	-29.60	(((((((..((((((((((((....))))))))))))...)))))))
junction:T_A rigid:8_1	CTAGGATATGGAAGATCCTTGGGAACAGGGATCTTCCTAAGTCCTAG	-29.20	(((((((..((((((((((((....))))))))))))...)))))))
junction:T_A rigid:9_0	CTAGGATATGGAAGATCCTGTGGAAATGGGATCTTCCTAAGTCCTAG	-26.60	(((((((..((((((((((((....))))))))))))...)))))))
junction:G_C rigid:0_9	CTAGGATATGGGAGATCCTGGGGAACTGGGATCTCCCTAAGTCCTAG	-30.70	(((((((..((((((((((((....))))))))))))...)))))))
junction:G_C rigid:1_8	CTAGGATATGGAGGATCCTGGGGAACTGGGATCCTCCTAAGTCCTAG	-30.70	(((((((..((((((((((((....))))))))))))...)))))))
junction:G_C rigid:2_7	CTAGGATATGGAAGATCCTGGGGAACTGGGATCTTCCTAAGTCCTAG	-28.30	(((((((..((((((((((((....))))))))))))...)))))))
junction:G_C rigid:3_6	CTAGGATATGGAAGGTCCTGGGGAACTGGGACCTTCCTAAGTCCTAG	-30.30	(((((((..((((((((((((....))))))))))))...)))))))
junction:G_C rigid:4_5	CTAGGATATGGAAGAGCCTGGGGAACTGGGCTCTTCCTAAGTCCTAG	-30.30	(((((((..((((((((((((....))))))))))))...)))))))
junction:G_C rigid:5_4	CTAGGATATGGAAGATGCTGGGGAACTGGCATCTTCCTAAGTCCTAG	-28.10	(((((((..((((((((((((....))))))))))))...)))))))
junction:G_C rigid:6_3	CTAGGATATGGAAGATCGTGGGGAACTGCGATCTTCCTAAGTCCTAG	-27.80	(((((((..((((((((((((....))))))))))))...)))))))
junction:G_C rigid:7_2	CTAGGATATGGAAGATCCGGGGGAACTCGGATCTTCCTAAGTCCTAG	-30.40	(((((((..((((((((((((....))))))))))))...)))))))
junction:G_C rigid:8_1	CTAGGATATGGAAGATCCTGGGGAACCGGGATCTTCCTAAGTCCTAG	-31.20	(((((((..((((((((((((....))))))))))))...)))))))
junction:G_C rigid:9_0	CTAGGATATGGAAGATCCTGGGGAACTGGGATCTTCCTAAGTCCTAG	-28.30	(((((((..((((((((((((....))))))))))))...)))))))
junction:C_G rigid:0_9	CTAGGATATGGCAGATCCTGGGGAACTGGGATCTGCCTAAGTCCTAG	-30.50	(((((((..((((((((((((....))))))))))))...)))))))
junction:C_G rigid:1_8	CTAGGATATGGACGATCCTGGGGAACTGGGATCGTCCTAAGTCCTAG	-29.90	(((((((..((((((((((((....))))))))))))...)))))))
junction:C_G rigid:2_7	CTAGGATATGGAACATCCTGGGGAACTGGGATGTTCCTAAGTCCTAG	-28.10	(((((((..((((((((((((....))))))))))))...)))))))
junction:C_G rigid:3_6	CTAGGATATGGAAGCTCCTGGGGAACTGGGAGCTTCCTAAGTCCTAG	-30.30	(((((((..((((((((((((....))))))))))))...)))))))
junction:C_G rigid:4_5	CTAGGATATGGAAGACCCTGGGGAACTGGGGTCTTCCTAAGTCCTAG	-30.30	(((((((..((((((((((((....))))))))))))...)))))))
junction:C_G rigid:5_4	CTAGGATATGGAAGATCCTGGGGAACTGGGATCTTCCTAAGTCCTAG	-28.30	(((((((..((((((((((((....))))))))))))...)))))))
junction:C_G rigid:6_3	CTAGGATATGGAAGATCCTGGGGAACTGGGATCTTCCTAAGTCCTAG	-28.30	(((((((..((((((((((((....))))))))))))...)))))))
junction:C_G rigid:7_2	CTAGGATATGGAAGATCCCGGGGAACTGGGATCTTCCTAAGTCCTAG	-31.20	(((((((..((((((((((((....))))))))))))...)))))))
junction:C_G rigid:8_1	CTAGGATATGGAAGATCCTCGGGAACGGGGATCTTCCTAAGTCCTAG	-30.40	(((((((..((((((((((((....))))))))))))...)))))))
junction:C_G rigid:9_0	CTAGGATATGGAAGATCCTGCGGAAGTGGGATCTTCCTAAGTCCTAG	-28.50	(((((((..((((((((((((....))))))))))))...)))))))
